??????????????????????????????????????????????????????????????????????????????????????????????????????????????
??????????????????????????????????????????????????????????????????????????????????????????????????????????????
??????????????????????????????????????????????????????????????????????????????????????????????????????????????
??????????????????????????????????????????????????????????????????????????????????????????????????????????????
????????????#####???????????????#####???????????????#####???????????????#####???????????????#####?????????????
??????????#########???????????#########???????????#########???????????#########???????????#########???????????
????????######.######???????######.######???????######.######???????######.######???????######.######?????????
??????######.###.######???######.###.######???######.###.######???######.###.######???######.###.######???????
??????####.#######.######?####.#######.######?####.#######.######?####.#######.######?####.#######.######?????
?????###.###########.#######.###########.#######.###########.#######.###########.#######.###########.####?????
?????#########.#######.###########.#######.###########.#######.###########.#######.###########.#######.##?????
????###.####.###.##########.####.###.##########.####.###.##########.####.###.##########.####.###.#########????
????##############.##.################.##.###.############.##.################.##.###.############.##.####????
????##.#.##.#####.#####.##.#.##.#####.#####.##.#.##.#####.#####.##.#.##.#####.#####.##.#.##.#####.#####.##????
????#########.#####.#############.#####.#############.#####.#############.#####.#############.#####.######????
????###.#######.######.####.#######.######.####.#######.######.####.#######.######.####.#######.######.###????
?????####.#######.###.#######.#######.###.#######.#######.###.#######.#######.###.#######.#######.###.####????
?????######.#######.###.#######.#######.###.#######.#######.###.#######.#######.###.#######.#######.###.##????
???????######.#######.####?######.#######.####?######.#######.####?######.#######.####?######.#######.####????
?????????######.##########???######.##########???######.##########???######.##########???######.##########????
???????????######.######???????######.######???????######.######???????######.######???????######.######??????
?????????????######.######???????######.######???????######.######???????######.######???????######.######????
???????????????######.#####????????######.####?????????######.####?????????######.####?????????######.####????
?????????????????######.###??????????######.##???????????######.##???????????######.##???????????######.##????
??????????##############.#########################################???????????#########????????????########????
????????##############.###################.###################.###??????????######.###????????????####.###????
??????######.###.###.####.####.###.###.#######.##............##.##??????????###.#####?????????????##.####?????
????######.###.###.#########.###.###.####.######....###.###...####??????????##.##.###?????????????####.###????
????####.#################.############.#######....##..#..##...###??????????####.###??????????????########????
????##.##############???####################?##...##.......##..##???????????###.####????????????????###.##????
????########????????????###.##???????#####???###...##.....##...##????????????####.###?????????????########????
????###.######??????????######???????????????####...##...##...###????????????########???????????######.###????
?????####.######????????##.###????????????????####...##.##...####??????????????###.###????????######.####?????
?????######.######??????######?????????????????####...###...####????????????????######??????######.######?????
???????######.######????###.#################?######...#...########################.##????######.######???????
?????????######.#####################################.....####################################.######?????????
???????????######.########..................####....#######...####..................########.######???????????
?????????????######.###.##..................##.......#####......##..................##.###.######?????????????
???????????????######...##########################.....#....#######################.##...######???????????????
????????###########....#############################......#############################....###########????????
????????#########....#####..................##...############...##..................#####....#########????????
???????###.####....###..##.#.#.#.#.#.#.#.#..###....########....###.#.#.#.#.#.#.#.#..##..###....####.###???????
?????########....###....##..#.#.#.#.#.#.#.#.###.......##......####..#.#.#.#.#.#.#.#.##....###....########?????
?????####.#....###......##..................#.####.....#....#.####..................##......###....#.####?????
?????##.##################.####################################.###################.##################.##?????
?????####################################################################################################?????
????####...###...##?????###.#..#..#..#..#..#######..#..#..#..#.####...##########...###?????##...###...####????
????###...###...###?????###................#####..............####......######......##?????###...###...###????
????##...###...####?????##..##############..###...##########...#######...####...######?????####...###...##????
????##..##...#####??????##..##############..##...############...##.####...##...####.##??????#####...##..##????
????##.##...#####???????##..##############..##..####......####..##..####......####..##???????#####...##.##????
????####...####?????????###......####......###..###...#.....##..##...####....####...##?????????####...####????
????####...###??????????####.....####.....####..###..#####......###...####..####...###??????????###...####????
?????##...###????????????####....####....#####..###..######.....####...########...####???????????###...##?????
????###...####????????????#####..####..#######..###..##?#############...######...####???????????####...###????
????####...######??????????####..####..####?##..###..##?#############...######...####??????????####...####????
????##.##...#######??????????##..####..##???##..###..######.....####...########...####???????#####...##.##????
????##..##.....#####?????????##..####..##???##..###..#####......###...####..####...###?????######...##..##????
????###..###.....####????????##..####..##???##..###...#.....##..##...####....####...##???######...###..###????
????####...###....####???????##..####..##???##..####......####..##..####......####..##?######...###...####????
?????####....###...############..####..##???##...############...##.####...##...####.#######...###....####?????
??????####.....###..###########..####..##???###...##########...#######...####...#########...###.....####??????
????#####...##...###..###.###.#........##???####..............#.##......######......###...###...##...#####????
????####...####....###..###.#####.##.####????#####..#..#..#.#####.##..##########..####..###....####...####????
????##.##################################?????############################??###########################.##????
????###################################????????#########################????##############################????
????###.####......##..###.....########????????####...........####??????#########....####...##....##....###????
?????####.#...##...##...###.....###########??####...###.###...####?###########....####...##..#..#.....###?????
?????#####...####...##..#####.......############...##..#..##...##########.......###########..####..######?????
?????####...######...##.########.........######...##.......##...#####.........######?######..####..#####??????
????####...##.##.##...####?#########......####.....##.....##...#####......########???????##..####..##?????????
????###...##.####.##...###????##########...##.......##...##...##.##...##########???????####..####..####???????
????##...##.##..##.##...##????????#########.#####....##.##...#####.#########????????#######..####..#######????
????##..##.##.##.##.##..###???????????########..###...###..###..########????????????#####....####....#####????
????##.##.##..##..##.##.###??????????????#####....##...#..##....#####???????????????##.......####.......##????
????####.##..####..##.##.##?????????????????####....##...##...####??????????????????####.##..####..##.####????
????##.......####.......###?????????????????##.###...####...###.##??????????????????##.##.##..##..##.##.##????
????#####....####....######?????????????????##..###...##...###..##??????????????????##..##.##.##.##.##..##????
????#######..####..#######??????????????????##...###......###...##??????????????????###..##.##..##.##..###????
???????####..####..####?????????????????????####...###...###...###??????????????????####...##.##.##...####????
??????#####..####..#######??????????????????#####...######...#####???????????????????####...######...####?????
?????######..####..#######????????????????????####...####...#####?????????????????????####...####...####??????
?????###.....#..#...##..##?????????????????????####...##...####????????????????????????####...##...######?????
?????##...###.##.###....##??????????????????????###...##...###??????????????????????????####......##.####?????
????###.####################################?####################??????????????#####?????#############.###????
????##############################################################?????????????######?####################????
????##.#####################..##..##..##..#####.##.##.##.##.##.###??????????..##..#####################.##????
????###..............#.####..##..##..##..##.##.#..#..#..#..#..#.##????????.##..##..####..............#.###????
????###.############.#.###..##..##..##..##...#.#..#..#..#..#..#.##????..##..##..##..###.############.#.###????
?????##.#..........#.#.###.##..##..##..##..####.##.##.##.##.##.###????#..##..##..##.###.#..........#.#.##?????
?????##.#.########.#.#.#####..##..##..##..####..................##???.##..##..##..#####.#.########.#.#.##?????
?????##.#.#......#.#.#.####..##..##..##..##.##.################.##???..##..##..##..####.#.#......#.#.#.##?????
?????##.#.#.####.#.#.#.###..##..##..##..##..##.################.##???#..##..##..##..###.#.#.####.#.#.#.##?????
?????##.#.#.#..#.#.#.#.###.##..##..##..##..###..................##?..##..##..##..##.###.#.#.#..#.#.#.#.##?????
?????##.#.#.#.##.#.#.#.#.###..##..##..##..###########.##############..##..##..##..#####.#.#.#.##.#.#.#.##?????
?????##.#.#.#.##.#.#.#.####..##..##..##..##.##......#...........##.##..##..##..##..####.#.#.#.##.#.#.#.##?????
?????##.#.#.#....#.#.#.###..##..##..##..##..##.################.##..##..##..##..##..###.#.#.#....#.#.#.##?????
?????##.#.#.######.#.#.###.##..##..##..##..###................#.###..##..##..##..##.###.#.#.######.#.#.##?????
?????##.#.#........#.#.#####..##..##..##..####.#####.########.#.####..##..##..##..#####.#.#........#.#.##?????
?????##.#.##########.#.####..##..##..##..##.##.....#.#...........#.##..##..##..##..####.#.##########.#.##?????
?????##.#............#.###..##..##..##..##..########.#######.#..##..##..##..##..##..###.#............#.##?????
?????##.##############.###.##..##..##..##..###.............#...P###..##..##..##..##.###.##############.##?????
?????##................#####..##..##..##..####.#############.#..#.##..##..##..##..####.................##?????
?????######################..##..##..##..##.##................####.##..##..##..##..#.####################?????
??????##################?###########################################??##################################??????
?????????????????????????#######################################???????################???????????????????????
??????????????????????????????????????????????????????????????????????????????????????????????????????????????
??????????????????????????????????????????????????????????????????????????????????????????????????????????????
??????????????????????????????????????????????????????????????????????????????????????????????????????????????
??????????????????????????????????????????????????????????????????????????????????????????????????????????????